"MAPA FASE 1",,,,,,,,,,,,,,,,,,,
32,32,32,32,32,32,32,32,32,32,32,32,32,32,32,32,32,32,32,32
32,28,28,28,28,28,28,28,28,28,28,28,28,28,28,28,28,28,28,32
32,28,28,28,28,28,28,28,28,28,28,28,28,28,28,28,28,28,28,32
32,28,28,27,27,27,28,28,28,28,28,28,28,28,28,28,28,28,28,32
32,28,28,27,27,27,28,28,28,28,28,28,28,28,28,28,28,28,28,32
32,28,28,27,27,27,28,28,28,28,28,28,28,28,28,28,28,28,28,32
32,28,28,28,28,28,28,28,28,28,28,28,28,28,28,28,28,28,28,32
32,28,28,28,28,28,28,28,28,28,28,28,28,28,32,28,28,28,28,32
32,28,28,28,28,28,28,28,28,28,28,28,28,32,50,32,28,28,28,32
32,28,28,28,28,28,28,28,28,28,28,28,32,50,50,50,32,28,28,32
32,28,28,28,28,28,28,28,28,28,28,32,50,50,50,50,50,32,28,32
32,28,28,28,28,28,28,28,28,28,32,50,50,50,39,40,50,50,32,32
32,28,31,30,30,28,28,28,28,28,28,32,50,50,41,42,50,32,28,32
32,28,30,30,30,28,28,28,28,28,28,32,50,50,43,44,50,32,28,32
32,28,30,30,30,28,28,28,28,28,28,32,50,50,50,50,50,32,28,32
32,28,28,29,28,31,30,28,28,28,28,32,50,50,50,50,50,32,28,32
32,28,28,29,28,30,30,28,28,28,28,38,50,50,33,34,50,32,28,32
32,28,28,29,28,28,29,28,48,49,28,37,50,50,35,36,50,32,28,32
32,45,45,29,45,45,29,45,46,47,45,38,50,50,35,36,50,32,45,32
32,32,32,32,32,32,32,32,32,32,32,32,32,32,32,32,32,32,32,32
